BOARD:
=================================
[0, 0, 0, 0, 0, 0, 0, 0, 0, 0, 0]
[0, 0, 0, 0, 0, 0, 0, 0, 0, 0, 0]
[0, 0, 1, 0, 0, 0, 0, 0, 0, 0, 0]
[0, 0, 1, 1, 1, 0, 1, 1, 1, 0, 0]
[0, 0, 1, 1, 1, 0, 1, 0, 1, 0, 0]
[0, 0, 1, 1, 1, 1, 1, 1, 1, 0, 0]
[0, 0, 1, 1, 1, 0, 1, 1, 1, 0, 0]
[0, 0, 1, 1, 1, 0, 1, 1, 1, 0, 0]
[0, 0, 1, 1, 0, 0, 0, 0, 2, 0, 0]
[0, 0, 0, 0, 0, 0, 0, 0, 0, 0, 0]
[0, 0, 0, 0, 0, 0, 0, 0, 0, 0, 0]
=================================
- START: (4, 4), (4, 4)
- LEFT: (4, 3), (4, 2)
- DOWN: (5, 3), (5, 2)
- RIGHT: (5, 4), (5, 4)
- RIGHT: (5, 5), (5, 6)
- RIGHT: (5, 7), (5, 7)
- DOWN: (6, 7), (7, 7)
- RIGHT: (6, 8), (7, 8)
- DOWN: (8, 8), (8, 8)
--> GOAL: (8, 8), (8, 8)
Time: 0.035 s
Memory: 31.89 MB